-------------------------------------------------------------------------------------------------
-------------------------------------------------------------------------------------------------
-------------------------------------------------------------------------------------------------
-------------------------------------------------------------------------------------------------
---------------------FFFFFFFFFFFFFF-----QCCCCCCCCCCCCCCCCCCCCD-----------------------------------
---------------------F************F-----GWWWWWWWWWWVWWWWWWWWWO-----------------------------------
---------------------F*****V******F-----G+N++++++++++++++++++O-----------------------------------
---------------------F********N***F-----G++++++++++++++++++++O-----------------------------------
---------------------F************F-----G+++++TA++++++TA+++++O---xxxxxxxxxxx---------------------
---------------------F************F-----G+++++LB++++++LB+++++O---xp;;;t;;;px---------------------
---------------------F************FFFFFFF++++++++++++++++++++xxxxx;;;;;;;;;x---------------------
---------------------F*******************+++++++++EM+++++++++;;;;;;;;;;;;;;x---------------------
---------------------F*******************+++++++++YR+++++++++;;;;;;;;;;;;;;x---------------------
---------------------F*******FFFFFFFFFFFF++++++++++++++++++++xxxxx;;;;;;;;;x---------------------
--------ÜÜÜÜÜÜÜÜÜÜÜÜÜÜ.......Ü----------G+++++TA++++++TA+++++O---xN;;;V;;;;x---------------------
--------Ü....................Ü----------G+++++LB++++++LB+++++O---xxxxxxxxxxx---------------------
--------Ü....................Ü----------G++++++++++++++++++++O-----------------------------------
--------Ü....................Ü----------G++++++++++++++++++++O-----------------------------------
--------Ü.....N..............Ü----------G++++++++++++++++++++O-----------------------------------
--------Ü........V...........Ü----------GCCCCCJ::JCCCCCCCCCCCO-----------------------------------
--------ÜÜÜÜÜÜÜÜÜÜÜÜÜÜÜÜÄJ::JÄ---------------Ä::::Ä----------------------------------------------
------------------------Ä::::Ä---------------Ä::::Ä----------------------------------------------
------------------------Ä::::ÄÄÄÄÄÄÄÄÄÄÄÄÄÄÄÄÄ::::Ä----------------------------------------------
------------------------Ä:::::N:::J:sofa:J::::::::Ä----------------------------------------------
------------------------Ä:::::::::::::::::::::::::Ä----------------------------------------------
------------------------Ä::::::::::::cu:::::::::::Ä----------------------------------------------
------------------------Ä:::::::::::::::::::::::::Ä----------------------------------------------
------------------------Ä:::::::::::::::::::::::::Ä----------------------------------------------
------------------------Ä:::::V:::::::::::::::::::Ä----------------------------------------------
------------------------ÄÄÄÄÄÄÄÄÄÄÄÄÄÄÄÄÄÄÄÄÄÄÄÄÄÄÄ----------------------------------------------
-------------------------------------------------------------------------------------------------
-------------------------------------------------------------------------------------------------
-------------------------------------------------------------------------------------------------